1 13 31
###############################
#pbbff ** *    *   *3 * * *   #
# #s# #*# # #*#*# # # #*#*#*# #
#  x*   f ***  *      *   * * #
# # # # # #*# # #*#*# # #  4 *#
#f    s    x **  *  *         #
# # # # # # # # # #*# #*      #
#*  * 1 s  *  *               #
# # # # #*# # # #*#*# #   2   #
#*    **  *   s   *2    *     #
# #*# # # # # # #*# # #       #
#    b      *   *  *          #
###############################